Genotype	Ssp
BHM	W
BHS	E
BNK	E
BSC	W
BVC	W
BVM	W
DDW	W
ECM	E
EGM	E
FLF	E
HMC	E
IRF	W
JAM	E
LTM	W
MAH	E
MFP	E
MIL	E
PAR	E
PCS	E
RUB	W
SAD	E
SIL	W
THT	W
VNH	W
WHC	W